Segment	Family
Tss	Promoter
TssF	Promoter
PromF	Promoter
Enh	Enhancer
EnhF	Enhancer
EnhW	Enhancer
EnhWF	Enhancer
DnaseD	Enhancer
DnaseU	Enhancer
FaireW	Enhancer
PromP	Poised
Gen5	Transcription
H4K20	Transcription
Pol2	Transcription
Elon	Transcription
ElonW	Transcription
Gen3	Transcription
Low	Transcription
CtcfO	Insulator
Ctcf	Insulator
ReprD	Repressed
Repr	Repressed
Art	Repressed
ReprW	Repressed
Quies	Repressed
